absorver->absorber
absorviendo->absorbiendo
acetado->aceptado
actualize->actualice
alcansado->alcanzado
almuerze->almuerce
aogado->ahogado
aprobechar->aprovechar
atrabesado->atravesado
atrabezado->atravesado
atravezado->atravesado
atrabesar->atravesar
atrabezar->atravesar
atravezar->atravesar
candadear->candear
cienes->cientos
cojer->coger
cojen->cogen
descuentado->descontado
desovediente->desobediente
deshechando->desechando
distorcionado->distorsionado
dotor->doctor
doptor->doctor
enlaze->enlace
enrredado->enredado
enrredar->enredar
equalizador->ecualizador
equalizar->ecualizar
exhuberante->exuberante
exitar->excitar
exemplo->ejemplo
explendor->esplendor
extrangero->extranjero
estranjero->extranjero
estrangero->extranjero
extricta->estricta
extricto->estricto
haiga->haya
hechar->echar
hechado->echado
hermita->ermita
interperie->intemperie
intrumento->instrumento
jente->gente
kms->km
llendo->yendo
lluviendo->lloviendo
lonjeva->longeva
lonjevo->longevo
luzes->luces
nadien->nadie
nadies->nadie
prerequisito->prerrequisito
protejer->proteger
quizo->quiso
regilla->rejilla
revizado->revisado
revizar->revisar
sacerdotiza->sacerdotisa
slogan->eslogan
substituir->sustituir
subrraya->subraya
tagea->tajea
vacear->vaciar
watios->vatios
